1111111111111111111111111111111111
1400000000000000000000000000000041
1011110111101111011111011110111101
101  101  10100001010141  10100101
1011110111101000010101011110100101
1010000100101000010101010010100101
1010000100101111010101010010100101
1000010000000000000000000000000001
1011010101011121110101010110100101
100000010101g333g10101010110100101
101101010101g333g10101000000100101
1011010101011111110101010110100101
1000000000000000000000010000100101
1011110111110101111101010110100101
1010000100000100000001000000100101
1010000111110101111101011110100101
1010000000010100000001400000100101
1011110111110101111101111110100101
1000000000000000000000000000100101
1011111101111111111111111110000101
14000000000000p0000000000000000041
1111111111111111111111111111111111

0 ball
1 wall
2 gate          (only one)
p pacman        (only one)
g ghost         (only four)
3 blank
4 power ball
